
help - Show a help message
chat - Directly chat with the bot
random - Show random personas
persona - Show the current persona
set - Set the persona to talk to
math-teacher - Act as a Math Teacher
rapper - Act as a Rapper
english-translator - Act as an English Translator and Improver
storyteller - Act as a Storyteller
financial-analyst - Act As A Financial Analyst
content-creator - Act as an Educational Content Creator
general - General Chat
poet - Act as a Poet
biblical-translator - Act as a Biblical Translator
python-interpreter - Act as a Python interpreter
personal-trainer - Act as a Personal Trainer
javascript-console - Act as a JavaScript Console
gaslighter - Act as a Gaslighter
excel-sheet - Act as an Excel Sheet
football-commentator - Act as a Football Commentator
recruiter - Act as a Recruiter
relationship-coach - Act as a Relationship Coach
dietitian - Act as a Dietitian
life-coach - Act as a Life Coach
social-media-manager - Act as a Social Media Manager
career-counselor - Act as a Career Counselor
chef - Act As A Chef
title-generator - Act as a Fancy Title Generator
advertiser - Act as an Advertiser
adventure-game - Act as a Text Based Adventure Game
motivational-coach - Act as a Motivational Coach
teacher - Act as an Instructor in a School
it-expert - Act as an IT Expert
developer-relations - Act as a Developer Relations consultant
lunatic - Act as a Lunatic
essay-writer - Act as an Essay Writer
accountant - Act as an Accountant
magician - Act as a Magician
comedian - Act as a Stand-up Comedian
logistician - Act as a Logistician
historian - Act as a Historian
debater - Act as a Debater
linux-terminal - Act as a Linux Terminal
regex-generator - Act as a Regex Generator
midjourney-generator - Act as a Midjourney Prompt Generator
mechanic - Act As An Automobile Mechanic
public-speaking-coach - Act as a Public Speaking Coach
travel-guide - Act as a Travel Guide
self-help - Act as a Self-Help Book
influencer - Act as a Social Media Influencer
real-estate-agent - Act as a Real Estate Agent
philosopher - Act as a Philosopher
writing-tutor - Act as an AI Writing Tutor
